{
    "maze": [
        [" "," ","#","#","#","#","#"," "],
        ["#","#","#"," "," "," ","#"," "],
        ["#","T","P","B"," "," ","#"," "],
        ["#","#","#"," ","B","T","#"," "],
        ["#","T","#","#","B"," ","#"," "],
        ["X"," ","#"," ","T"," ","#","#"],
        ["#","B"," ","D","B","B","T","#"],
        ["#"," "," "," ","T"," "," ","#"],
        ["#","#","#","#","#","#","#","#"]
    ]
}